4 4 4 4 4 4 4 4 4 4 4 4 4 4 4 4 4 4 4 4 4 4 4 4 4 4 4 4 4 4 4 4 4 4 4 4 4 4 4 4 4 4 4 4 4 4 4 4 4 4 4 4 4 4 4 4 4 4 4 4 4 4 4 4 4 4 4 4 4 4 4 4 4 4 4 4 4 4 4 4 4 4 4 4 4
4 4 4 4 4 4 4 4 4 4 4 4 4 4 4 4 4 4 4 4 4 4 4 4 4 4 4 4 4 4 4 4 4 4 4 4 4 4 4 4 4 4 4 4 4 4 4 4 4 4 4 4 4 4 4 4 4 4 4 4 4 4 4 4 4 4 4 4 4 4 4 4 4 4 4 4 4 4 4 4 4 4 4 4 4
4 4 4 4 4 4 4 4 4 4 4 4 4 4 4 4 4 4 4 4 4 4 4 4 4 4 4 4 4 4 4 4 4 4 4 4 4 4 4 4 4 4 4 4 4 4 4 4 4 4 4 4 4 4 4 4 4 4 4 4 4 4 4 4 4 4 4 4 4 4 4 4 4 4 4 4 4 4 4 4 4 4 4 4 4
4 4 4 4 4 4 4 4 4 4 4 179 180 180 180 182 4 4 179 180 180 180 180 180 180 180 180 180 180 180 180 180 180 180 180 180 180 180 180 180 180 180 180 180 180 182 4 4 179 180 180 180 180 180 180 180 180 180 180 180 180 180 182 4 179 180 180 180 180 180 182 4 4 4 4 4 4 4 4 4 4 4 4 4 4
4 4 4 4 4 4 4 4 179 180 180 64 33 33 33 198 4 4 195 33 33 33 33 33 33 33 33 33 33 33 33 33 33 33 33 33 33 33 33 33 33 33 33 33 33 198 4 4 195 33 33 33 33 33 33 33 33 33 33 33 33 33 65 180 64 33 33 33 33 33 65 180 180 180 180 180 182 4 4 4 4 4 4 4 4
4 4 4 4 4 4 4 179 64 33 33 33 33 33 33 198 4 4 195 33 33 33 33 33 33 33 33 33 33 33 33 33 33 33 33 33 33 33 33 33 33 33 33 33 33 65 180 180 64 33 33 33 33 33 33 33 33 33 33 33 33 33 33 33 33 33 33 33 33 33 33 33 33 33 33 33 65 182 4 4 4 4 4 4 4
4 4 4 4 4 4 4 195 33 33 33 33 33 33 33 65 180 180 64 33 33 33 33 33 33 33 38 49 49 49 49 49 49 36 33 33 33 33 33 33 33 53 33 33 33 33 33 33 33 33 33 33 33 33 33 33 33 33 33 33 33 33 33 33 33 33 33 33 33 33 33 33 33 33 33 33 33 65 182 4 4 4 4 4 4
4 4 4 4 4 4 179 64 33 33 33 33 33 33 33 33 33 33 33 33 33 33 33 33 33 33 35 2 2 2 2 2 2 48 49 49 49 36 33 38 36 53 38 49 49 36 33 33 33 33 33 33 33 33 33 33 33 33 33 38 49 49 49 49 49 49 49 49 36 33 33 33 33 33 33 33 33 33 65 180 182 4 4 4 4
4 4 4 4 4 4 195 33 33 33 33 33 33 33 33 33 33 33 33 33 33 38 36 33 33 33 22 19 2 2 2 2 2 2 2 2 16 20 33 35 52 53 54 2 2 48 49 49 36 33 33 33 38 49 49 36 33 33 38 51 2 2 2 2 2 2 2 2 48 49 49 49 36 33 33 33 33 33 33 33 198 4 4 4 4
4 4 4 4 4 4 195 33 33 33 33 33 33 38 49 49 49 49 36 33 38 51 48 49 36 33 33 22 17 19 2 2 2 2 16 17 20 33 38 51 52 53 54 2 2 2 2 2 32 33 38 49 51 2 2 32 33 33 22 19 2 2 2 2 2 2 2 2 2 2 2 2 48 49 36 33 33 33 33 33 198 4 4 4 4
4 4 4 4 4 4 195 33 33 33 33 38 49 51 2 2 2 2 52 33 54 2 2 2 48 36 33 33 33 22 2 2 2 2 20 33 33 38 51 2 52 53 54 2 2 2 2 2 32 33 22 19 2 2 2 48 36 33 33 22 17 17 17 19 2 2 2 2 2 2 2 2 2 2 48 36 33 33 33 33 198 4 4 4 4
4 4 4 4 4 4 211 213 80 33 33 35 2 2 2 2 2 2 52 33 51 2 2 2 2 48 49 36 33 33 2 2 2 2 33 33 38 51 2 2 52 53 54 2 2 2 2 2 32 33 33 35 2 2 2 2 48 36 33 33 33 33 33 22 17 17 17 17 17 17 19 2 2 2 2 48 36 33 33 33 65 182 4 4 4
4 4 4 4 4 4 4 4 195 33 33 35 2 2 2 2 2 2 52 33 54 2 2 2 2 2 2 48 36 33 33 33 33 33 33 38 51 2 2 2 52 53 54 2 2 2 2 2 48 36 33 35 2 2 2 2 2 48 49 49 49 36 33 33 33 33 33 33 33 33 22 17 17 19 2 2 32 33 33 33 33 198 4 4 4
4 4 4 4 179 180 180 180 64 33 33 35 2 2 2 2 2 16 20 33 54 2 2 2 2 2 2 2 48 49 2 2 2 2 50 51 2 2 2 2 52 53 54 2 2 2 2 16 17 20 33 35 2 2 2 2 2 2 2 2 2 48 49 49 49 49 49 49 36 33 33 33 33 22 2 2 48 36 33 33 33 198 4 4 4
4 4 4 4 195 33 33 33 33 33 33 35 2 2 2 2 16 20 33 33 54 2 2 2 2 2 2 2 2 2 2 2 2 2 2 2 2 2 2 2 52 53 54 2 2 2 16 20 33 33 33 35 2 2 2 2 2 2 2 2 2 2 2 2 2 2 2 2 48 49 49 36 33 33 22 19 2 32 33 33 33 198 4 4 4
4 4 4 4 195 33 33 33 33 33 38 51 2 2 2 16 20 33 33 38 2 2 2 2 2 2 2 2 2 2 2 2 2 2 2 2 2 2 2 2 52 53 54 2 2 2 32 33 33 38 50 51 2 2 2 2 2 2 2 2 2 2 2 2 2 2 2 2 2 2 2 48 36 33 33 22 18 20 33 33 33 198 4 4 4
4 4 4 4 195 33 33 33 33 38 51 2 2 2 16 20 33 33 38 51 2 2 2 2 2 2 2 2 2 2 2 2 2 2 2 2 2 2 2 2 52 53 54 2 2 2 48 49 49 51 2 2 2 2 2 2 2 2 2 2 2 2 2 2 2 2 2 2 2 2 2 2 48 36 33 33 33 33 33 33 33 198 4 4 4
4 4 4 4 195 33 33 33 33 35 2 2 16 17 20 33 33 33 35 2 2 2 2 2 2 2 2 2 2 2 2 2 2 2 2 2 2 2 2 2 52 53 54 2 2 2 2 2 2 2 2 2 2 2 2 2 2 2 2 2 2 2 2 2 2 2 2 2 2 2 2 2 2 48 36 33 33 33 33 33 33 198 4 4 4
4 4 4 4 195 33 33 33 33 35 2 16 20 33 33 33 33 33 22 19 2 2 2 2 2 2 2 2 2 2 2 2 2 2 2 2 2 2 2 2 52 53 54 2 2 2 2 2 2 2 2 2 2 2 2 2 2 2 2 2 2 2 2 2 2 2 2 2 2 2 2 2 2 16 20 33 33 33 33 33 33 198 4 4 4
4 4 4 4 195 33 33 33 33 22 19 32 33 33 33 38 36 33 33 35 2 2 2 2 2 2 2 2 2 2 2 2 2 2 2 2 2 2 2 2 52 53 54 2 2 2 2 2 2 2 2 2 2 2 2 2 2 2 2 2 2 2 2 2 2 2 2 2 2 2 2 2 16 20 33 33 33 33 33 33 33 198 4 4 4
4 4 4 4 195 33 33 33 33 33 35 48 36 33 33 35 2 36 33 35 2 2 2 2 2 2 2 2 2 2 2 2 2 2 2 2 2 2 2 16 20 1 22 19 2 2 2 2 2 2 2 2 2 2 2 2 2 2 2 2 2 2 2 2 2 2 2 2 2 2 2 2 32 33 33 38 49 36 33 33 33 198 4 4 4
4 4 4 4 211 213 213 80 33 33 35 2 48 36 33 35 2 32 33 22 17 17 17 17 17 17 17 17 17 17 17 17 17 17 17 17 17 17 17 20 33 33 34 22 17 17 17 17 17 17 17 17 17 17 17 17 17 17 17 17 17 17 17 17 17 17 17 19 2 2 2 2 32 33 33 35 2 32 33 33 33 198 4 4 4
4 4 4 4 4 4 4 195 33 33 35 2 2 32 33 35 2 32 33 33 33 53 53 53 53 53 53 53 53 53 53 53 53 53 53 53 53 53 53 37 33 33 33 53 53 53 53 53 53 53 53 53 53 53 53 53 53 53 53 53 53 53 53 53 53 53 53 35 2 2 2 2 32 33 33 22 17 20 33 33 33 198 4 4 4
4 4 4 4 4 179 180 64 33 33 35 2 2 32 33 35 2 32 33 33 38 50 50 50 50 50 50 50 50 50 50 50 36 33 38 50 50 50 50 36 37 53 37 38 50 50 50 50 50 50 50 50 50 50 50 50 50 50 50 50 50 50 50 50 50 50 50 51 2 2 2 2 48 36 33 33 33 33 33 33 33 198 4 4 4
4 4 4 4 4 195 33 33 33 33 35 2 16 20 33 35 16 20 33 33 35 2 2 2 2 2 2 2 2 16 18 18 20 33 54 2 2 2 2 48 36 37 38 51 2 2 2 2 2 2 2 2 2 2 2 2 2 2 2 2 2 2 2 2 2 2 2 2 2 2 2 2 2 48 49 49 49 36 33 33 33 198 4 4 4
4 4 4 4 4 195 33 33 33 33 22 19 32 33 33 35 32 33 33 38 51 2 2 2 2 2 2 2 2 32 33 38 49 49 51 2 2 2 2 2 52 53 54 2 2 2 2 2 2 2 2 16 17 17 17 17 17 17 17 17 18 19 2 2 2 2 2 2 2 2 2 2 2 2 2 2 2 32 33 33 33 198 4 4 4
4 4 4 4 4 195 33 33 33 33 33 22 20 33 33 22 20 33 33 22 19 2 2 2 2 2 2 2 2 32 33 22 19 2 2 2 2 2 2 2 52 53 54 2 2 2 2 2 2 2 2 32 33 33 33 33 33 33 33 33 33 22 19 2 2 2 2 2 2 2 2 2 16 17 17 17 17 20 33 33 33 198 4 4 4
4 4 4 4 4 211 80 33 33 33 33 33 33 33 33 33 33 33 33 33 22 19 2 2 2 2 2 2 2 32 33 33 35 2 2 2 2 2 2 2 52 53 54 2 2 2 2 2 2 2 2 32 33 33 38 49 49 49 49 36 33 33 22 19 2 2 2 2 2 2 2 16 20 33 33 33 33 33 33 33 33 198 4 4 4
4 4 4 4 4 4 195 33 33 33 33 33 33 33 33 33 33 33 33 33 33 35 2 2 2 2 2 2 2 48 36 33 22 19 2 2 2 2 2 2 52 53 54 2 2 2 2 2 2 2 2 48 36 33 22 19 2 2 2 48 36 33 33 22 19 2 2 2 2 2 16 20 33 33 38 36 33 33 33 33 33 198 4 4 4
4 4 4 4 4 4 195 33 33 33 38 50 50 36 33 33 33 33 33 38 49 51 2 2 2 2 2 2 2 2 32 33 33 35 2 2 2 2 2 2 52 53 54 2 2 2 2 2 2 2 2 2 48 36 33 35 2 2 2 2 48 36 33 33 35 2 2 2 16 17 20 33 33 38 51 32 33 33 33 33 33 198 4 4 4
4 4 4 4 4 4 195 33 33 33 22 19 2 48 36 33 33 33 33 22 19 2 2 2 2 2 2 2 2 2 32 33 33 35 2 2 2 2 2 2 52 53 54 2 2 2 2 2 2 2 2 2 2 32 33 35 2 2 2 2 2 48 36 33 22 19 2 2 32 33 33 38 49 51 2 32 33 33 33 33 33 198 4 4 4
4 4 4 4 4 4 211 80 33 33 33 22 19 2 48 36 33 33 33 33 22 17 19 2 2 2 2 2 2 16 20 33 33 35 2 2 2 2 2 2 52 53 54 2 2 2 2 2 2 2 2 2 16 20 33 35 2 2 2 2 2 2 32 33 33 35 2 16 20 33 38 51 16 17 17 20 33 33 33 33 81 214 4 4 4
4 4 4 4 4 4 4 195 33 33 33 33 22 19 2 48 36 33 33 33 33 33 22 19 16 17 17 17 17 20 33 33 38 51 2 2 2 2 2 2 52 53 54 2 2 2 2 2 2 2 2 2 32 33 33 35 2 2 2 2 2 2 48 36 33 22 17 20 33 33 22 17 20 33 33 33 33 33 33 33 198 4 4 4 4
4 4 4 4 4 4 4 211 80 33 33 33 33 22 19 2 48 36 33 33 33 33 33 22 20 33 33 33 33 33 33 33 22 2 2 2 16 102 101 102 102 86 102 102 102 102 19 2 2 2 2 16 20 33 38 51 2 2 2 2 2 16 17 20 33 33 33 33 33 33 33 33 33 33 33 33 33 33 33 81 214 4 4 4 4
4 4 4 4 4 4 4 4 211 80 33 33 33 33 22 19 2 48 50 50 36 33 33 33 33 33 38 49 36 33 33 33 33 22 17 2 32 33 117 118 118 118 118 118 119 33 35 2 2 2 2 20 33 33 35 2 2 2 2 2 16 20 33 33 33 33 33 33 33 33 33 33 33 33 33 33 33 33 81 214 4 4 4 4 4
4 4 4 4 4 4 4 4 4 195 33 33 33 33 33 22 19 2 2 2 32 33 33 33 33 38 51 2 48 36 33 33 33 33 33 22 20 33 133 134 134 134 134 134 135 33 35 2 2 16 20 33 33 38 51 2 2 2 16 17 20 33 33 33 33 33 33 33 33 33 33 33 33 33 33 33 33 81 214 4 4 4 4 4 4
4 4 4 4 4 4 4 4 4 211 80 33 33 33 33 33 22 17 17 17 20 33 33 33 33 35 2 2 2 48 36 33 33 33 33 33 33 33 149 150 150 150 150 150 151 33 22 17 17 20 33 38 49 51 2 2 2 16 20 33 33 33 33 33 33 33 81 213 213 80 33 33 33 81 213 213 213 214 4 4 4 4 4 4 4
4 4 4 4 4 4 4 4 4 4 211 80 33 33 33 33 33 33 33 33 33 33 33 33 33 35 2 2 2 2 48 49 49 36 33 81 212 212 165 166 166 166 166 166 167 212 80 33 33 33 33 22 17 17 17 17 17 20 33 33 33 33 33 33 33 33 198 4 4 195 33 81 213 214 4 4 4 4 4 4 4 4 4 4 4
4 4 4 4 4 4 4 4 4 4 4 211 213 213 213 80 33 33 33 34 34 34 34 33 33 22 19 2 2 2 16 18 18 20 33 198 4 4 4 4 4 4 4 4 4 4 195 33 33 33 33 33 33 33 33 33 33 33 33 33 33 33 33 33 33 33 198 4 4 211 213 214 4 4 4 4 4 4 4 4 4 4 4 4 4
4 4 4 4 4 4 4 4 4 4 4 4 4 4 4 195 33 33 33 81 212 212 212 80 33 33 22 17 17 17 20 33 33 33 33 198 4 4 4 4 4 4 4 4 4 4 195 33 33 33 33 33 33 33 33 33 33 33 33 33 33 33 33 81 213 213 214 4 4 4 4 4 4 4 4 4 4 4 4 4 4 4 4 4 4
4 4 4 4 4 4 4 4 4 4 4 4 4 4 4 211 213 213 213 214 4 4 4 195 34 33 33 33 33 33 33 33 33 33 33 198 4 4 4 4 4 4 4 4 4 4 195 33 33 33 33 33 33 33 33 33 33 33 33 33 33 33 81 214 4 4 4 4 4 4 4 4 4 4 4 4 4 4 4 4 4 4 4 4 4
4 4 4 4 4 4 4 4 4 4 4 4 4 4 4 4 4 4 4 4 4 4 4 195 34 34 34 34 34 34 34 34 34 34 34 198 4 4 4 4 4 4 4 4 4 4 195 33 33 33 33 33 33 33 33 33 33 33 81 213 213 213 214 4 4 4 4 4 4 4 4 4 4 4 4 4 4 4 4 4 4 4 4 4 4
4 4 4 4 4 4 4 4 4 4 4 4 4 4 4 4 4 4 4 4 4 4 4 211 212 212 212 212 212 212 212 212 212 212 212 214 4 4 4 4 4 4 4 4 4 4 211 213 213 213 213 213 213 213 213 213 213 213 214 4 4 4 4 4 4 4 4 4 4 4 4 4 4 4 4 4 4 4 4 4 4 4 4 4 4
4 4 4 4 4 4 4 4 4 4 4 4 4 4 4 4 4 4 4 4 4 4 4 4 4 4 4 4 4 4 4 4 4 4 4 4 4 4 4 4 4 4 4 4 4 4 4 4 4 4 4 4 4 4 4 4 4 4 4 4 4 4 4 4 4 4 4 4 4 4 4 4 4 4 4 4 4 4 4 4 4 4 4 4 4
4 4 4 4 4 4 4 4 4 4 4 4 4 4 4 4 4 4 4 4 4 4 4 4 4 4 4 4 4 4 4 4 4 4 4 4 4 4 4 4 4 4 4 4 4 4 4 4 4 4 4 4 4 4 4 4 4 4 4 4 4 4 4 4 4 4 4 4 4 4 4 4 4 4 4 4 4 4 4 4 4 4 4 4 4
4 4 4 4 4 4 4 4 4 4 4 4 4 4 4 4 4 4 4 4 4 4 4 4 4 4 4 4 4 4 4 4 4 4 4 4 4 4 4 4 4 4 4 4 4 4 4 4 4 4 4 4 4 4 4 4 4 4 4 4 4 4 4 4 4 4 4 4 4 4 4 4 4 4 4 4 4 4 4 4 4 4 4 4 4
4 4 4 4 4 4 4 4 4 4 4 4 4 4 4 4 4 4 4 4 4 4 4 4 4 4 4 4 4 4 4 4 4 4 4 4 4 4 4 4 4 4 4 4 4 4 4 4 4 4 4 4 4 4 4 4 4 4 4 4 4 4 4 4 4 4 4 4 4 4 4 4 4 4 4 4 4 4 4 4 4 4 4 4 4
4 4 4 4 4 4 4 4 4 4 4 4 4 4 4 4 4 4 4 4 4 4 4 4 4 4 4 4 4 4 4 4 4 4 4 4 4 4 4 4 4 4 4 4 4 4 4 4 4 4 4 4 4 4 4 4 4 4 4 4 4 4 4 4 4 4 4 4 4 4 4 4 4 4 4 4 4 4 4 4 4 4 4 4 4
